R 800 700
NO ./textures/greystone.png
SO ./textures/colorstone.png
WE ./textures/eagle.png
EA ./textures/redbrick.png

S ./path_to_the_sprite_texture

F 180,18,180
C 14,144,14

11111111111111111111
10000000000000000001
10010101000000000001
10010000000000000001
10010000000000000001
10000000000000000001
10000000111000000001
10000000111000000001
10000000000000000001
10000000000000000001
10000000000000000001
10000000000000000001
10000000000000000001
100000000000000000N1
11111111111111111111