R 800 700
NO ./textures/greystone.png
SO ./textures/colorstone.png
WE ./textures/eagle.png
EA ./textures/redbrick.png

S ./path_to_the_sprite_texture
F 200,200,200
C 20,20,20

11111111111111111111
10000000000000000001
10000000000000000001
10000000000000000001
10000000000000000001
10000000000000000001
10000000111000000001
10000000111000000001
10000000111000000001
10000000000000000001
10010000000000000001
10010000000000000001
10011110000000000001
10000000000000000001
11111111111111111111
