R 1280 720
NO ./textures/colorstone.png
SO ./textures/bluestone.png
WE ./textures/wood.png
EA ./textures/purplestone.png

S ./textures/barrel.png
S ./textures/pillar.png
S ./textures/greenlight.png
ST ./textures/tnt.png

FT ./textures/greystone.png
CT ./textures/mossy.png

F 200, 80, 200
C 80, 200, 80

11111111111111111111
10000000000000000001
10010101000000000001
10010000000000400001
10010000000000000001
10000000000000000001
10000000111000000001
1000001H111002000001
10000010100000000001
1000000000N000000001
10003000000000000001
10000000000000000001
10000000000000000001
10000000000000000001
11111111111111111111