R 1270 720
NO ./textures/greystone.xpm
SO ./textures/mossy.xpm
WE ./textures/greystone.xpm
EA ./textures/bluestone.xpm

SI ./textures/collectible.xpm
BD ./textures/eagle.xpm

FT ./textures/colorstone.xpm

F 1, 2, 3
C 0, 0, 1

1111111
1IIIII1
1IIIII1
100N001
1IIIII1
1IIIII1
1111111
