R 1000 800
NO ./textures/greystone.xpm
SO ./textures/mossy.xpm
WE ./textures/greystone.xpm
EA ./textures/bluestone.xpm

SI ./textures/collectible.xpm
BD ./textures/eagle.xpm

FT ./textures/colorstone.xpm

F 1, 2, 3
C 0, 0, 11

1111111
1IIIII1
1IIIII1
100N001
1IIII01
1IIIII1
1111111
