R 1270 720
NO ./textures/greystone.xpm
SO ./textures/mossy.xpm
WE ./textures/greystone.xpm
EA ./textures/mossy.xpm

SI ./textures/collectible.xpm
BD ./textures/eagle.xpm

FT ./textures/colorstone.xpm

F 200, 80, 200
C 80, 200, 80

1111111
1IIIII1
1IIIII1
100N001
1IIIII1
1IIIII1
1111111

