R 1270 720
NO ./textures/tnt.png
SO ./textures/tnt.png
WE ./textures/tnt.png
EA ./textures/tnt.png

S ./textures/barrel.png

FT ./textures/tnt.png
CT ./textures/tnt.png

F 200, 80, 200
C 80, 200, 80

1111111
1000001
1002001
100N001
1000001
1000001
1111111