R 1270 720
NO ./textures/tnt.png
SO ./textures/tnt.png
WE ./textures/tnt.png
EA ./textures/tnt.png

S ./textures/barrel.png

FT ./textures/tnt.png
CT ./textures/tnt.png

F 200, 80, 200
C 80, 200, 80

11111111111111111111
10000000000000000001
10010101000000000001
10010000000000000001
10010000000000000001
10000000000000000001
10000000111000000001
10000000111002000001
10000000000000000001
1000000000N000000001
10000000000000000001
10000000000000000001
10000000000000000001
10000000000000000001
11111111111111111111