R 1280 720
NO ./textures/colorstone.png
SO ./textures/bluestone.png
WE ./textures/wood.png
EA ./textures/purplestone.png

F 200, 80, 200
C 80, 200, 80

1111110111111
1000011100011
1000000000001
1111111100001
1000000000001
1000000000001
10000000000N1
1111111100001
0000000111111